******************
*----------------*
*----------------*
*----------------*
*----------------*
*---------------->
*----------------*
*----------------*
*----------------*
*----------------*
*----------------*
*********v********