******************
*----------------*
*----------------*
*----------------*
*----------------*
<----------------*
*----------------*
*----------------*
*----------------*
*----------------*
*----------------*
*********v********