*********^********
*----------------*
*----------------*
*----------------*
*----------------*
*---------------->
*----------------*
*----------------*
*----------------*
*----------------*
*----------------*
******************