*********^********
*----------------*
*----------------*
*----------------*
*----------------*
<----------------*
*----------------*
*----------------*
*----------------*
*----------------*
*----------------*
******************